####################################################################################
#list of regular expressions to sort random text by, from highest priority to lowest
#sso.txt, called by sso.pl
##############the numbers are: capitalization (1=sentence 2=title 3=all caps) | punctuation | quotes (1=necc 0=either way -1=neither)
!	t	t1=animal friends t2=elm/merle t3=battle t4=machines t5=taunts
!	g	g1=cuss g2=death g3=empty g4=help g5=no g6=nonvi g7=sing g8=sleep g9=undo g0=undo rej g10=wait g11=yessage
!	o	o2=rappers (o3=biopics) o4=comedians o5=elmo o6=games o7=movies o8=talkshows o9=tvshows o0=lafhouse o01=lousyhit o02=mob o03=oldies (o04=books) o05=chatter
!	h	h1=political slogans (default h2 = selly yells)
!	p	p1=bedding p2=catechism p3=lr chat p4=lr idols p5=research p6=smart ppl
!	u	u1=horbert bye u2=musings u4=deli foods u5=moralizers (u3=ALL CAPS)
!	s	s1=lecture s2=movies s3=porn movies s4=ads s5=competitors
!	r	r1=crowd r2=red bull
!  v v1=sked items v2=divorces v3=iffy advice v4=gritty v5=non-skeds v6=posh v7=bosses v8=fancy bums v9=real est ads v0=bestsellers vx=your songs
!  w w1=gizmo w2=rodney
!  y y1=aunt y2=bar y3=casper y4=other bars y5=fish fries y6=theses y7=gossip y8=girls
!  ms 1=camp 2=condo 3=nerds 4=psa
####################################################################################
################first default booleans
table of biopics~FALSE
table of ad slogans~FALSE
################now table main regexes/notifiers
table of cussing rejects	xxg1	cuss	swear
table of death messages	xxg2	death	die
table of empty command rejects	xxg3	mt	empty
table of help companies	xxg4	help	aid
table of noage	xxg5	no	n
table of nonviolence messages	xxg6	att	non
table of singing rejects	xxg7	sing
table of sleep rejects	xxg8	sleep	zzz	zz
table of undo allows	xxg9	undoy	undo-y	uy
table of undo rejects	xxg0	undon	undo-n	un
table of wait responses	xxg10	wait	z
table of yessage	xxg11	yes	y
table of ad slogans	xxm1	ad	ads
table of bad rappers	xxm2	rap
table of biopics	xxm3	bio
table of comedians	xxm4	comed	comedy	com
table of elmo emo	xxm5	elmo	emo
table of lame computer games	xxm6	gm	gam	game	games
table of lame movies	xxm7	mov	movie	movies
table of lame talk shows	xxm8	talk
table of lame tv shows	xxm9	tv
table of laughhouses	xxm0	laf	laff
table of lousy hit songs	xxm01
table of mob chants	xxm02	mob
table of oldies singers	xxm03	old
table of random books	xxm04	bk
table of sports chatter	xxm05
table of idiotic lecture points	xxs1
table of overdone movies	xxs2
table of sicko movies	xxs3
table of store c ads	xxs4
table of store c competitors	xxs5
table of tokers nonsense	xxs6
table of horbert farewells	xxu1
table of horbert musings	xxu2
table of mantle laments	xxu3
table of missing deli foods	xxu4
table of moralizers	xxu5
table of sked items	xxv1
table of DIVORCES articles	xxv2
table of iffy advice	xxv3
table of gritty dialogue	xxv4
table of non-skeds	xxv5
table of posh dialogue	xxv6
table of posse bosses	xxv7
table of prestigious bums	xxv8
table of real estate ads	xxv9
table of self-help bestsellers	xxv0
table of songs you could write	xxvx
table of bedding brands	xxp1
table of catechism pages	xxp2
table of Leo-Rand chitchat	xxp3
table of Leo-Rand idols	xxp4
table of research topics	xxp5
table of smartypants	xxp6
table of aunt tuna chatter	xxy1
table of bar dialogue	xxy2
table of Casper mumbles	xxy3
table of competing bars	xxy4
table of fish fries	xxy5
table of theses	xxy6
table of tuna gossip	xxy7
table of unpopular girls	xxy8
table of gizmo parts	xxw1	gizmo	giz
table of rodney bluster	xxw2	rodney	rod
table of animal friends	xxt1
table of Elmer and Merle squabbles	xxt2
table of Elvira battle cries	xxt3
table of Elvira machines	xxt4
table of Elvira taunts	xxt5
table of political slogans	xxh1
table of selly yells	xxh2
####################################
# Shuffling Around
table of job searcher names	xxx	x	name	names
table of evil locations	xxf	f	evil
table of poem codas	xxi	i	poem
table of camp chants	xxms1	camp
table of condo dialogue	xxms2	condo
table of nerd natter	xxms3	nerd	nerds
table of psas	xxms4	psa	psas
table of red bull taunts	xxr1	rbb	bull
table of riot slogans	xxr2	riot	riots
;
